     #####
     #---#
     #$--#
   ###--$##
   #--$-$-#
 ###-#-##-#   ######
 #---#-##-#####--..#
 #-$--$-----@----..#
 #####-###-####--..#
     #-----#  ######
     #######