  ############
  #----#-----###
  #..--#-$-$---#
  #..--#-####$-#
  #..-----@##--#
  #..--#$#----##
  ######-##-$--#
    #-$----$-$-#
    #----#-----#
    ############