   #####
   #@-###
   #-$--#
  ###-#-#
  #.#-#--#
  #.$--#-#
  #.---$-#
  ########